1 1 1 1 1 1 1 1 1 1 1 1 1 1 1 1
0 0 0 0 0 0 0 0 0 0 0 0 0 0 0 1 
0 0 0 0 0 0 3 3 3 3 3 3 3 3 3 1
0 0 0 0 0 0 1 4 4 4 4 4 4 4 4 1
0 0 0 0 0 0 5 2 2 2 2 2 2 2 2 1
0 0 3 3 3 3 5 2 2 2 2 2 2 2 2 1
0 0 0 0 0 0 5 2 2 2 2 2 2 2 2 1
0 0 0 0 0 0 1 4 4 4 4 4 4 4 4 1 
0 0 0 0 0 0 3 3 3 3 3 3 3 3 3 1
0 0 0 0 0 0 0 0 0 0 0 0 0 0 0 1
0 0 0 0 0 0 0 0 0 0 0 0 0 0 0 1
1 1 1 1 1 1 1 1 1 1 1 1 1 1 1 1 



